E S E O S
E E E O O
O O E O O
E E E E O
F O E E F
